________________________________________________________________
________________________________________________________________
_________cc____________cc________________cc____________cc_______
________________________________________________________________
________________________________________________________________
________________________________________________________________
________________________________________________________________
_____ee______ee______ee______ee______ee______ee______ee______ee_
________________________________________________________________
______cc______cc______cc______cc______cc______cc______cc______cc
